﹁	「
﹂	」
﹃	﹁
﹄	﹂
伲	你
倮	裸
凇	淞
処	处
凼	幽
剳	劄
勋	勋
勦	剿
哌	呱
嗬	呵
向	向
囯	国
坂	阪
墒	墑
奖	奖
采	采
尜	嘎
崐	昆
嵛	崳
巌	岩
幷	并
录	录
彚	汇
捜	搜
擀	搟
暸	瞭
术	术
桔	橘
矩	矩
椝	规
叹	叹
氽	汆
沲	沱
浜	滨
湿	湿
炤	照
煅	锻
呆	呆
珉	玟
珏	玨
琯	管
产	产
畲	畬
疱	疱
眎	视
礡	礴
祢	祢
稭	秸
紥	扎
线	线
坛	坛
肀	聿
修	修
药	药
蔴	麻
蝰	虺
蟮	蟺
证	证
赃	赃
躰	体
郃	合
郄	隙
钟	钟
钻	钻
锉	剉
鋻	鉴
锤	锤
录	录
鉴	鉴
闲	闲
閧	哄
靣	面
𫘤	呆
鶏	鸡
鸡	鸡
！象	！像
‘	『
’	』
“	「
”	」
「恩！	「嗯！
「当！	「当！
「当」	「当」
0海里	0海里
０海里	０海里
0里	0里
０里	０里
1海里	1海里
１海里	１海里
1里	1里
１里	１里
2海里	2海里
２海里	２海里
2里	2里
２里	２里
3海里	3海里
３海里	３海里
3里	3里
３里	３里
4海里	4海里
４海里	４海里
4里	4里
４里	４里
5海里	5海里
５海里	５海里
5里	5里
５里	５里
6海里	6海里
６海里	６海里
6里	6里
６里	６里
7海里	7海里
７海里	７海里
7里	7里
７里	７里
8海里	8海里
８海里	８海里
8里	8里
８里	８里
9海里	9海里
９海里	９海里
9里	9里
９里	９里
一干就	一干就
一斗不	一斗不
一出剧院	一出剧院
一只只	一只只
一海里	一海里
七海里	七海里
九海里	九海里
二海里	二海里
人象	人像
八海里	八海里
十海里	十海里
又干又	又干又
又松	又松
又象	又像
三海里	三海里
上冲洗	上冲洗
也象	也像
千海里	千海里
口干一	口干一
口干什	口干什
口干那	口干那
口干活	口干活
口干员	口干员
口干掉	口干掉
口干这	口干这
口干着	口干著
子姜	子姜
山涯	山崖
已松	已松
已松下	已松下
已象	已像
已象征服	已像征服
已象征战	已像征战
已经象	已经像
干肉贩	干肉贩
干似	干似
干的好	干的好
干疤	干疤
干面前	干面前
干孙	干孙
干掉杯	干掉杯
干货物	干货物
干窘	干窘
干阳	干阳
干尽一壶	干尽一壶
干涧	干涧
干坛	干坛
干搁	干搁
干瞪	干瞪
干声	干声
才干了杯	才干了杯
才干干净	才干干净
才干那杯	才干那杯
才干枯	才干枯
才干耗	才干耗
才干脆	才干脆
才干涸	才干涸
才干净	才干净
才干爽	才干爽
才干这杯	才干这杯
才干着急	才干著急
才不干枯	才不干枯
才不干涸	才不干涸
才不干燥	才不干燥
才象	才像
不修篇幅	不修边幅
不象	不像
五海里	五海里
仍象	仍像
内函	内涵
六海里	六海里
分象	分像
升泰	升泰
反朴归真	反璞归真
天佑	天祐
太象	太像
尤如	犹如
尤带	犹带
尤疑	犹疑
尤怜	犹怜
尤豫	犹豫
心系统	心系统
手表示	手表示
手表现	手表现
手表达	手表达
手表态	手表态
手表演	手表演
扎彩	扎彩
扎着	扎著
扎稳	扎稳
支签	支签
斗的过	斗的过
斗擞	抖擞
木纳	木讷
火拼	火拚
他白干	他白干
他象	他像
他象征战	他像征战
令媛	令嫒
包函	包涵
包卷	包卷
北游	北游
半海里	半海里
去干一杯	去干一杯
去干了杯	去干了杯
去干洗	去干洗
去干耗	去干耗
去干净	去干净
去干着急	去干著急
去卷	去卷
可以象	可以像
可象	可像
可象征战	可像征战
古法自制	古法自制
叼扰	叨扰
叼难	刁难
只大老鼠	只大老鼠
只牛	只牛
只犬	只犬
只巨兽	只巨兽
只母老虎	只母老虎
只羊	只羊
只老狐狸	只老狐狸
只老虎	只老虎
只老鼠	只老鼠
只兔	只兔
只怪物	只怪物
只怪兽	只怪兽
只招子	只招子
只狗	只狗
只狐狸	只狐狸
只虎	只虎
只狼	只狼
只畜生	只畜生
只马	只马
只鬼	只鬼
只猛兽	只猛兽
只蛋	只蛋
只野兽	只野兽
只鸟	只鸟
只鹿	只鹿
只猴	只猴
只狮	只狮
只凤	只凤
只猪	只猪
只猫	只猫
只鸡	只鸡
只骡	只骡
只驴	只驴
四海里	四海里
它象	它像
必游	必游
必须品	必需品
戊戍	戊戌
戊卫	戍卫
打不准	打不准
未松下	未松下
未愈	未愈
正象	正像
玉佩	玉珮
生克	生克
白白干	白白干
白淅	白皙
白澈	白皙
目定口呆	目瞪口呆
石象	石像
石膏象	石膏像
仿徉	彷徉
仿效	倣傚
全象	全像
共制	共制
共御	共御
再卷	再卷
再象	再像
同仇敌慨	同仇敌忾
吊系	吊系
吊念	吊念
吊信	吊信
吊贺	吊贺
吊钱	吊钱
吐干	吐干
合并且	合并且
吃茶	吃茶
回光反照	回光反照
地卷	地卷
多出电影	多出电影
奸拐	奸拐
好象	好像
她象	她像
如坐针毯	如坐针毡
宅弟	宅第
宅紫	姹紫
弛骋	驰骋
曲薛	曲薛
朱喻	朱喻
朱矶	朱矶
百海里	百海里
竹框	竹筐
竹荀	竹笋
竹杆	竹竿
而象	而像
舟揖	舟楫
衣驱	衣袪
西装毕挺	西装笔挺
佛象	佛像
估不准	估不准
伺奉	侍奉
伸卷	伸卷
作崇	作祟
你白干	你白干
你象	你像
低迥	低回
伶敏	灵敏
余海里	余海里
克苦	刻苦
克剜	克剜
即象	即像
君子好求	君子好逑
告侥	告饶
吹卷	吹卷
吹须	吹须
吮干	吮干
夹衣	裌衣
夹袄	裌袄
彷佛	仿佛
快卷	快卷
我白干	我白干
我象	我像
抉别	诀别
扼塞	阨塞
折卷	折卷
扮象	扮像
更象	更像
决择	抉择
汨没	汩没
没白干	没白干
没辄	没辙
灸热	炙热
狂卷	狂卷
系引	系引
系手	系手
系乎	系乎
系妥	系妥
系起	系起
系挂	系挂
系绊	系绊
系块	系块
系脚	系脚
肖象	肖像
谷麦	谷麦
谷稻	谷稻
豆鼓	豆豉
身系	身系
巡戈	巡弋
防碍	妨碍
劭雍	邵雍
并砌	并砌
并图	并图
并赃	并赃
事干脆	事干脆
事干净	事干净
些象	些像
函洞	涵洞
函容	涵容
函意	涵意
函煦	涵煦
函义	涵义
函管	涵管
函蓄	涵蓄
函盖	涵盖
函养	涵养
函濡	涵濡
函蕴	涵蕴
刻象	刻像
刻象征服	刻像征服
刮胡须	刮胡须
制丹	制丹
制器	制器
卒草	捽草
卒悉	窣窸
卒发	捽发
卓约风姿	绰约风姿
卷出	卷出
卷伏	卷伏
卷向	卷向
卷好	卷好
卷至	卷至
卷伴	卷伴
卷身	卷身
卷往	卷往
卷拂	卷拂
卷卧	卷卧
卷飞	卷飞
卷个	卷个
卷射	卷射
卷得	卷得
卷扫	卷扫
卷涌	卷涌
卷碎	卷碎
卷罩	卷罩
卷滚	卷滚
卷舞	卷舞
卷裹	卷裹
卷荡	卷荡
卷袭	卷袭
取谛	取缔
呷干	呷干
呼卷	呼卷
周息	周息
坦护	袒护
姑负	辜负
岳立	岳立
岳峙	岳峙
店铺	店舖
弦管	弦管
彼彼皆是	比比皆是
忽松	忽松
念一声	念一声
所扎	所扎
所卷	所卷
抿灭	泯灭
抹台	抹台
抹刹	抹煞
抽佣	抽佣
拙壮	茁壮
抵砺	砥砺
抬扛	抬摃
易斗的	易斗的
昏瞑	昏暝
松化	松化
松去	松去
松甩	松甩
松肘	松肘
松泛	松泛
松肩	松肩
松骨	松骨
松筋	松筋
松闲	松闲
松腰	松腰
松齿	松齿
松绳	松绳
注：	注：
泥象	泥像
沾污	玷污
沾辱	玷辱
治疔	治疗
物志	物志
的亮发	的亮发
直卷	直卷
直发抖	直发抖
罔罔	惘惘
罔然	惘然
虎咽	虎咽
初斗然	初陡然
初愈	初愈
金象奖	金像奖
长台	长台
长发布	长发布
长象	长像
陀手	舵手
陀表	陀表
阿腴	阿谀
青笞	青苔
青棵	青稞
非常象	非常像
非象	非像
非象征服	非像征服
囹围	囹圉
信缄	信笺
便松	便松
便象	便像
剌刀	刺刀
则象	则像
则象征服	则像征服
则象征战	则像征战
却象	却像
咽一口	咽一口
咽入	咽入
咽口水	咽口水
咽不下	咽不下
咽回	咽回
咽食	咽食
咽得下	咽得下
咽嚼	咽嚼
型状	形状
奕棋	弈棋
姜油	姜油
姜花	姜花
姜愈老	姜愈老
姜葱	姜葱
姜醋	姜醋
姣洁	皎洁
很象	很像
急卷	急卷
恰象	恰像
挖松	挖松
拼一拼	拚一拚
拼上一拼	拚上一拚
拼个	拚个
既象	既像
映象	映像
是白干	是白干
柔发	柔发
流卷	流卷
活象	活像
抵犊情深	舐犊情深
玲胧	玲珑
甚松	甚松
相形见拙	相形见绌
相象	相像
看不准	看不准
看出电影	看出电影
砌并	砌并
竽头	芋头
背系	背系
胡鬓	胡鬓
茅芦	茅庐
英寸	英吋
衫毕挺	衫笔挺
要冲凉	要冲凉
迥廊	回廊
迥避	回避
迨尽	殆尽
面线	面线
面馍	面馍
面摊牌	面摊牌
面摊开	面摊开
音不准	音不准
风姿卓约	风姿绰约
眈误	耽误
倒卷	倒卷
倒象	倒像
俱象	俱像
个象	个像
准以为	准以为
哪象	哪像
娉亭	娉婷
射不准	射不准
席子	席子
座象	座像
徒峭	陡峭
径自	迳自
径取	迳取
径庭	迳庭
径砸	迳砸
径寄	迳寄
径启	迳启
径答	迳答
恭逢	躬逢
捂不住	摀不住
捂住	摀住
捉只	捉只
捉狭	促狭
挺而	铤而
挺象	挺像
挽近	挽近
效尤	傚尤
效法	傚法
旁徨	徬徨
旁惶	徬徨
株象	株像
栓住	拴住
殷勤	慇勤
气慨	气概
浪卷	浪卷
海函	海涵
疾卷	疾卷
盍盍	溘溘
盍逝	溘逝
盍然	溘然
盍谢	溘谢
眩耀	炫耀
真知卓见	真知灼见
真象	真像
真缔	真谛
神只	神祇
神佑	神祐
神祗	神祇
神象	神像
租贷	租赁
笆蕉	芭蕉
笑容可鞠	笑容可掬
笑讷	笑纳
笑魇	笑靥
纯系	纯系
耗干	耗干
能干休	能干休
能干政	能干政
能干笑	能干笑
能干嚎	能干嚎
能干搁	能干搁
能干瞪	能干瞪
能象	能像
荆朴	荆璞
茶干掉	荼干掉
茶干尽	茶干尽
起来象	起来像
躬敬	恭敬
轫性	韧性
迷罔	迷惘
迷朦	迷蒙
回然	迥然
回响当	回响当
追朔	追溯
追根究抵	追根究柢
闪铄	闪烁
陡松	陡松
只鹰	只鹰
马僵	马缰
高干脆	高干脆
捋胡	捋胡
畛怀	轸怀
做到象	做到像
偶象	偶像
倏松	倏松
兜卷	兜卷
勘乱	戡乱
商铺	商舖
婀挪	婀娜
寂聊	寂寥
康愈	康愈
强干杯	强干杯
强干涉	强干涉
强干脆	强干脆
强干预	强干预
强干扰	强干扰
强御	强御
彩杖	彩杖
彩牌	彩牌
彩裳	彩裳
得象	得像
徜若	倘若
凄息	栖息
凄戚	凄戚
戚嗟	戚嗟
戚忧	戚忧
戚颜	戚颜
掘松	掘松
扫卷	扫卷
挣松	挣松
排泄	排泄
掀卷	掀卷
捻手	撚手
教悔	教诲
斛斗	觔斗
旋卷	旋卷
旋涡	漩涡
梗直	鲠直
清淅	清晰
混肴	混淆
淬厉	淬砺
犁牛	牦牛
猛卷	猛卷
琅嬛	瑯嬛
瓷制	瓷制
略松	略松
畦径	畦迳
眼困	眼困
眼框	眼眶
累累	累累
羞赦	羞赧
舶船	泊船
船浆	船桨
船蓬	船篷
船纤	船纤
莫明其妙	莫名其妙
被卷	被卷
通谍	通牒
通辑	通缉
连抉	连袂
造象	造像
郭朴	郭璞
都象	都像
钓游	钓游
竟象	竟像
顶顶大名	鼎鼎大名
劳骚	牢骚
喧染	渲染
喝三坛	喝三坛
喝两坛	喝两坛
喉干	喉干
孱杂	羼杂
寒仓	寒伧
寒喧	寒暄
就象	就像
嵇首	稽首
帽璎	帽缨
几乎象	几乎像
几海里	几海里
复亡	覆亡
复叠	覆叠
徨恐	惶恐
悲泯	悲悯
揩台	揩台
揉躏	蹂躏
挥卷	挥卷
摒息	屏息
敢再干杯	敢再干杯
敢松	敢松
斑烂	斑斓
棵象	棵像
钦崎	嵚崎
游兵	游兵
游巡	游巡
游狎	游狎
游军	游军
游唱	游唱
游蜂	游蜂
游豫	游豫
涌卷	涌卷
浑函	浑涵
然无幸	然无幸
然象	然像
琢制	琢制
画象	画像
番薯	蕃薯
痉孪	痉挛
发皓	发皓
发髯	发髯
硬拼	硬拚
稍松	稍松
等侯	等候
笋况	荀况
丝制	丝制
评击	抨击
象一	像一
象二	像二
象人	像人
象三	像三
象已	像已
象之前	像之前
象什	像什
象今	像今
象水	像水
象片	像片
象以往	像以往
象以前	像以前
象他	像他
象它	像它
象平时	像平时
象永	像永
象在	像在
象她	像她
象有	像有
象自己	像自己
象似	像似
象你	像你
象我	像我
象那	像那
象些	像些
象两	像两
象往	像往
象所有	像所有
象雨	像雨
象是	像是
象昨	像昨
象甚	像甚
象要	像要
象风	像风
象个	像个
象刚	像刚
象鬼	像鬼
象带	像带
象您	像您
象现	像现
象这	像这
象吗	像吗
象极	像极
象当	像当
象话	像话
象过去	像过去
象梦	像梦
象疯	像疯
象银	像银
象样	像样
象谁	像谁
象赞	像赞
越象	越像
开铺	开舖
闲遐	闲暇
闲静	闲静
雇有	雇有
雇舟	雇舟
雇车	雇车
雇马	雇马
雇船	雇船
雇请	雇请
云：	云：
云宵	云霄
须求	需求
须鬓	须鬓
饨面	饨面
饮三坛	饮三坛
饮而干	饮而干
饮两坛	饮两坛
喑哑	瘖哑
蛩音	跫音
轸域	畛域
倾刻	顷刻
倾复	倾覆
汇萃	荟萃
圆椎	圆锥
塑象	塑像
微松	微松
微须	微须
意兴阑姗	意兴阑珊
想干笑	想干笑
想干脆	想干脆
想干净	想干净
愈合心	愈合心
愈合乎	愈合乎
愈合他	愈合他
愈合用	愈合用
愈合式	愈合式
愈合作	愈合作
愈合我	愈合我
愈合身	愈合身
愈合拍	愈合拍
愈合理	愈合理
愈合意	愈合意
愈合适	愈合适
愈合拢	愈合拢
愈卷	愈卷
愈象	愈像
会象	会像
榔头	𨱍头
极待救	亟待救
极待解	亟待解
极象	极像
极极	亟亟
毁谤	毁谤
溶炉	熔炉
溜达	溜跶
烟没	湮没
照象	照像
猷豫	犹豫
当然罗！	当然啰！
碗干	碗干
碗素面	碗素面
禁若寒蝉	噤若寒蝉
万只怕	万只怕
经斗数	经斗数
经白干	经白干
罩卷	罩卷
群象	群像
圣象	圣像
肆业	肄业
腮胡	腮胡
装璜	装潢
里面冲身	里面冲身
里象	里像
袅雄	枭雄
解象	解像
解签	解签
该象	该像
跟跄	踉跄
较象	较像
农获	农获
运筹惟幄	运筹帷幄
逼奸	逼奸
遐疵	瑕疵
窣悉	窣窸
侥悻	侥幸
喽罗	喽啰
图象	图像
实象	实像
屡仆	屡仆
旗幡	旗旛
暝目	瞑目
榴连	榴梿
歉咎	歉疚
滚卷	滚卷
算不准	算不准
紧扎	紧扎
紧卷	紧卷
绸密	稠密
舔干	舔干
舞卷	舞卷
蒙蒙胧	朦朦胧
蒙瞀	蒙瞀
蒙瞢	蒙瞢
蒙瞽	蒙瞽
说签	说签
轻挑	轻佻
轻篾	轻蔑
铜象	铜像
衔土	啣土
衔泥	啣泥
衔草	啣草
衔环	啣环
颇象	颇像
魁悟	魁梧
魂游	魂游
僵绳	缰绳
凛列	凛洌
唠叼	唠叨
嘴干	嘴干
坠胎	堕胎
娇揉造作	矫揉造作
幡间	墦间
厮斗然	厮陡然
影象	影像
憔瘁	憔悴
扑卷	扑卷
撬松	撬松
数海里	数海里
暴卷	暴卷
枢钮	枢纽
潦阔	辽阔
潮卷	潮卷
熨干	熨干
璀灿	璀璨
盘卷	盘卷
瞌然长逝	溘然长逝
确系着	确系著
稽康	嵇康
稻杆	稻秆
箱函	箱涵
编篡	编纂
缈茫	渺茫
胶制	胶制
诸候	诸侯
谁干脆	谁干脆
践道	栈道
铺位	舖位
震松	震松
髯发	髯发
儆效	儆傚
憋脚	蹩脚
坛酒	坛酒
坛醋	坛醋
强界	疆界
懈迨	懈怠
挞虏	鞑虏
朴玉	璞玉
横卷	横卷
机抒	机杼
独游	独游
遗象	遗像
遗撼	遗憾
录象	录像
锦镖	锦标
锱衣	缁衣
雕象	雕像
雕落	雕落
腼典	腼腆
颈系	颈系
头扎	头扎
头亮发	头亮发
头发出	头发出
头发生	头发生
头发呆	头发呆
头发狂	头发狂
头发育	头发育
头发现	头发现
头发麻	头发麻
颓圯	颓圮
肴撰	肴馔
骼膊	胳膊
壑然	豁然
弥散	弥散
徽菌	霉菌
应象	应像
戏彩	戏彩
擢足	濯足
滥芋充数	滥竽充数
烩干	烩干
环佩	环珮
璨烂	灿烂
篾箪	篾簟
篷松	篷松
糟塌	糟蹋
糟达	蹧跶
糟遢	糟蹋
膺品	赝品
亵读	亵渎
豁壑	谿壑
购并不	购并不
购并且	购并且
还象	还像
还象征服	还像征服
邂怠	懈怠
襁保	襁褓
归究	归咎
归依佛门	皈依佛门
归依我佛	皈依我佛
归里	归里
归朴	归璞
箫条	萧条
绣象	绣像
觞子	殇子
丰谀	丰腴
蹒顸	颟顸
转戾点	转捩点
转寰	转圜
锁碎	琐碎
双并	双并
啮齿	囓齿
拢断	垄断
疆弩之末	彊弩之末
签卜	签卜
签文	签文
签爪	签爪
罗唆	啰唆
罗哩	啰哩
罗嗦	啰嗦
罗里罗苏	啰哩啰苏
罗罗苏苏	啰啰苏苏
罗难	罹难
罗苏	啰苏
药制	药制
蟹螫	蟹螯
邋塌	邋遢
邋蹋	邋遢
醮墨	蘸墨
铲去	铲去
铲灭	铲灭
难斗的	难斗的
籍口	借口
纂位	篡位
蕴函	蕴涵
蕴酿	酝酿
褴缕	褴褛
警剔	警惕
骚首弄姿	搔首弄姿
摄服	慑服
摄象	摄像
缠卷	缠卷
蜡象	蜡像
响当	响当
飙卷	飙卷
听不准	听不准
鞑伐	挞伐
颤斗	颤抖
挛生	孪生
显象	显像
惊螫	惊蛰
羁拌	羁绊
谶悔	忏悔
灵俐	伶俐
骤松	骤松
鬓须	鬓须
箩卜	萝卜
蛮干净	蛮干净
蛮干燥	蛮干燥
镶制	镶制
镶崁	镶嵌
代码	程式码
任务栏	工作列
位图	点阵图
信号	讯号
优先级	优先顺序
光标	游标
光盘	光碟
光驱	光碟机
内存	记忆体
内置	内建
刻录	烧录
创建	建立
加载	载入
卸载	解除安装
图标	图示
在线	线上
多任务	多工
多态	多型
字体	字型
密钥	金钥
对话框	对话方块
导入	汇入
卷积	折积
扫描仪	扫描器
文档	文件
枚举	列举
模块	模组
状态栏	状态列
用户	使用者
异步	非同步
粘贴	贴上
绑定	系结
网上邻居	网路上的芳邻
网关	闸道器
编程	程式设计
缩进	缩排
声卡	音效卡
脱机	离线
脚本	指令码
虚拟机	虚拟机器
视图	检视
视频	视讯
设备	装置
设置	设定
调用	呼叫
调试器	侦错程式
远程	远端
队列	伫列
集群	丛集
显卡	显示卡
显存	视讯记忆体
点击	点选