﹃	﹁
﹄	﹂
﹁	﹃
﹂	﹄
丼	井
伕	夫
佪	徊
侚	徇
倣	仿
偪	逼
偺	咱
傚	效
僊	仙
僣	僭
儅	当
凅	涸
剉	锉
劄	札
劻	匡
勗	勖
勦	剿
匋	陶
卄	廿
卬	昂
叡	睿
吋	寸
呎	尺
咷	啕
唝	唝
啗	啖
啣	衔
囓	啮
圏	圈
坵	丘
埜	野
埼	崎
墑	墒
墫	樽
姪	侄
婬	淫
媮	偷
媿	愧
嬝	袅
嬭	奶
寘	置
屝	扉
崠	岽
崳	嵛
嵒	岩
幷	并
庂	仄
廱	痈
彚	汇
徬	旁
惇	敦
惷	蠢
慇	殷
懃	勤
戉	钺
扐	仂
扞	捍
扱	插
扺	抵
抃	拚
抔	抱
抴	曳
拑	钳
挌	格
挶	局
揹	背
搆	构
搟	擀
搥	捶
搨	打
搯	掏
搾	榨
摀	捂
摃	扛
撚	拈
撢	掸
撦	扯
擡	抬
攷	考
旛	幡
晞	曦
晢	晰
晳	晰
晻	暗
暱	昵
暸	了
朢	望
杇	圬
栒	旬
桮	杯
梱	捆
楄	匾
楙	茂
楜	胡
槃	盘
橦	幢
櫂	棹
櫐	累
櫺	棂
欸	唉
殀	夭
殽	肴
毌	毋
毘	毗
毬	球
汍	丸
沍	冱
洟	涕
浬	里
湣	闵
潟	舄
澂	澄
澔	浩
濬	浚
瀁	漾
炤	照
炰	炮
煖	暖
燄	焰
燐	磷
燿	耀
牠	它
狚	旦
玅	妙
玆	兹
玨	珏
珪	圭
珮	佩
瑯	琅
瓖	镶
甪	角
畬	畲
疿	痱
痲	麻
痳	麻
痺	痹
瘉	愈
睪	睾
瞇	眯
砲	炮
碪	砧
祂	他
祅	祆
祐	佑
祼	裸
秏	耗
稨	扁
穨	颓
笻	筇
箄	箅
箠	棰
篛	箬
篲	彗
簷	檐
籐	藤
籥	龠
粧	妆
縚	绦
繙	翻
缾	瓶
罦	罘
耑	端
耡	助
耤	藉
肏	操
肐	胳
胇	肺
胊	朐
膆	嗉
臕	膘
臙	胭
舋	衅
舖	铺
艸	艹
苺	莓
茍	苟
荅	答
荳	豆
菫	堇
蔆	菱
薙	剃
蘗	蘖
虖	呼
蜺	霓
蟺	蟮
蠷	蠼
衒	炫
袪	祛
褎	袖
襾	西
覜	眺
觔	筋
觝	抵
詶	酬
詻	咯
諠	喧
謼	呼
譔	撰
谿	溪
豖	亍
貍	狸
賸	剩
跼	局
踡	蜷
踫	碰
蹧	糟
迆	迤
迺	乃
酖	鸩
醆	盏
醼	宴
釆	采
銲	焊
鋻	鉴
鎗	枪
鐉	铣
鑤	刨
鑵	罐
阨	厄
阬	坑
阯	址
陏	隋
隄	堤
霤	溜
餽	馈
駮	驳
騣	鬃
髣	仿
鴈	雁
鶏	鸡
鷰	燕
鼇	鳌
兀	兀
『	‘
』	’
平行计算	并行计算
资料库	数据库
资料探勘	数据挖掘
资料来源	数据源
登录档	注册表
调色盘	调色板
PN接面	PN结
中介软体	中间件
序列	串行
互动	交互
互动式	交互式
人工智慧	人工智能
工作列	任务栏
工作管理员	任务管理器
模拟	仿真
点阵图	位图
资讯	信息
资讯理论	信息论
讯号	信号
通道	信道
感测	传感
优先顺序	优先级
游标	光标
光碟	光盘
光碟机	光驱
记忆体	内存
内建	内置
全形	全角
相容	兼容
刀锋伺服器	刀片服务器
解析度	分辨率
剪下	剪切
剪贴簿	剪贴板
建立	创建
载入	加载
半形	半角
部落格	博客
解除安装	卸载
控制代码	句柄
指令式程式设计	命令式编程
命令列	命令行
韧体	固件
图示	图标
都会网路	城域网
堆叠	堆栈
场效电晶体	场效应管
外接	外置
多工	多任务
多型	多态
栏位	字段
字元	字符
字串	字符串
位元组	字节
字型	字体
存档	存盘
单核心	宏内核
暂存器	寄存器
金钥	密钥
真实模式	实模式
宽频	宽带
定址	寻址
对话方块	对话框
遮蔽	屏蔽
巢状	嵌套
频宽	带宽
撷取	截取
列印	打印
折积	卷积
扫描器	扫描仪
运算元	操作数
支援	支持
数位印刷	数字印刷
数位电路	数字电路
资料仓储	数据仓库
阵列	数组
档案	文件
资料夹	文件夹
文书处理	文字处理
文字	文本
文件	文档
分时多工	时分复用
时脉频率	时钟频率
闸流体	晶闸管
电晶体	晶体管
终端使用者	最终用户
解构函式	析构函数
列举	枚举
建构函式	构造函数
模组	模块
正规表示式	正则表达式
位元	比特
新增	添加
原始档	源文件
简报	演示文稿
无失真压缩	无损压缩
实体记忆体	物理内存
状态列	状态栏
使用者	用户
使用者名称	用户名
智慧财产权	知识产权
硬碟	硬盘
分码多重进接	码分多址
磁碟	磁盘
磁轨	磁道
行动硬碟	移动硬盘
行动网路	移动网络
行动电话	移动电话
埠	端口
贴上	粘贴
元件	组件
网路上的芳邻	网上邻居
网咖	网吧
闸道器	网关
执行绪	线程
程式设计	编程
程式语言	编程语言
快取	缓存
缩图	缩略图
缩排	缩进
预设	缺省
音效卡	声卡
离线	脱机
指令码	脚本
晶片	芯片
虚拟函式	虚函数
视讯	视频
直译器	解释器
触控式萤幕	触摸屏
装置	设备
设定	设置
呼叫	调用
侦错程式	调试器
变数	变量
软碟机	软驱
通讯	通信
远端	远程
逻辑闸	逻辑门
重新命名	重命名
入口网站	门户网站
快闪记忆体	闪存
关联式资料库	关系数据库
伫列	队列
积体电路	集成电路
丛集	集群
云端储存	云存储
音讯	音频
页首	页眉
页尾	页脚
显示卡	显卡
视讯记忆体	显存
飞航模式	飞行模式
快取记忆体	高速缓存
预设值	默认值
点选	点击
滑鼠	鼠标